11111111111111111111111
10000000000000000000001
10P00000000000000000001
10000C000000C0000000001
10000000000000000000001
100000000C0000000000001
10000000000000000000001
1000000000000C000000001
10000000000000000000001
10000000000000000000001
10000000000000000000E01
11111111111111111111111