111111111111111111111111111111
1P1000C000000E11111C00000000C1
10101110111011111C110111101001
101000000000001000000000000001
101011101111101101111100111001
101C100000000C00000000000C1001
1C1011111111011111111110000011
1010000000C0000000C00000000101
101011101111111110111110000101
101000100C00000000000010101001
10101C101110111111111010101011
101010000000000C000000000001C1
101111111111111111111111110101
10000000000C000000000000000001
11100C00111111100011111C111111
111111111111111111111111111111