11111111111111111111
10P00000000000000001
10000C000000C0000001
10000000000000000001
10000000000000000001
1000000000000C00E001
10000000000000000001
10000000000000000001
10000000000000000001
11111111111111111111