111111111111111111111111111
1E00000000000000C00000C0001
101001010010000010100010101
101001001010101000100101101
1P0000000C00C00001C10000001
111111111111111111111111111