1111111111111111111111111111111111
1000000000000000C00000C000000000E1
1010010100100000101001000000010111
1010010010101010001001000000010101
100000000C00C000000000001C10000001
1111111111111111111111111111111111